CASP8,	DISC_TNF & !cFLIP | DISC_FAS & !cFLIP | CASP3 & !cFLIP
RIP1ub,	cIAP & RIP1
DISC_TNF,	TNFR & FADD
BCL2,	NFkB
apoptosis,	CASP3
cIAP,	cIAP & !SMAC | !SMAC & NFkB
RIP1k,	RIP1
DISC_FAS,	FADD & FASL
MOMP,	!(!MPT & !BAX)
Cyt_c,	MOMP
MPT,	!BCL2 & ROS
SMAC,	MOMP
RIP1,	!CASP8 & DISC_FAS | !CASP8 & TNFR
CASP3,	!XIAP & apoptosome
ATP,	!MPT
TNFR,	TNF
survival,	NFkB
XIAP,	!SMAC & NFkB
ROS,	MPT & !NFkB | RIP1k & !NFkB
BAX,	CASP8 & !BCL2
apoptosome,	Cyt_c & ATP & !XIAP
cFLIP,	NFkB
IKK,	RIP1ub
NonACD,	!ATP
NFkB,	!CASP3 & IKK
FADD,	FADD
TNF,	TNF
FASL,	FASL